Substructure Identifier;Substructure Name;Substructure SMILES;Entire Landscape Distribution - Score;Chemical Class Distribution - Score;Entire Landscape Fraction / Average Flexibility - Score;Chemical Class Fraction / Average Flexibility - Score;Total Score;Rank;Substructure Category
Substructure_0003;phenyl-R;[R]C1=CC=CC=C1;10;10;10;10;40;1;Primary Positive Substructure
Substructure_0009;phenol-R;OC1=CC=CC=C1;8;7;9;8;32;2;Primary Positive Substructure
Substructure_0013;"methoxy, defined (3H; CH)";[R]OC([H])([H])[H];4;7;8;10;29;3;Primary Positive Substructure
Substructure_0002;ethylene;CC;10;10;4;4;28;4;Primary Positive Substructure
Substructure_0001;methylene;C;10;10;3;3;26;5;Primary Positive Substructure
Substructure_0044;"hydroxy-H, defined (1H; OH)";[R]O[H];6;7;6;7;26;5;Primary Positive Substructure
Substructure_0015;"methoxy-H-phenyl, defined (3H; CH)";[H]C([H])([H])OC1=CC=CC=C1;4;6;6;9;25;6;Primary Positive Substructure
Substructure_0008;propylene;CCC;6;10;3;4;23;7;Primary Positive Substructure
Substructure_0006;dimethylamine-R;CNC;5;8;3;4;20;8;Primary Positive Substructure
Substructure_0007;ether;[R]O[R];6;7;3;4;20;8;Primary Positive Substructure
Substructure_0014;methylethylamine-R;CNCC;5;8;3;4;20;8;Primary Positive Substructure
Substructure_0053;"4-hydroxy-R-phenyl-R, defined (4H; CH)";[R]C1=C(C([H])=C(O)C([H])=C1[H])[H];3;2;9;6;20;8;Primary Positive Substructure
Substructure_0062;"phenol-H, defined (1H; OH)";[H]OC1=CC=CC=C1;4;4;6;6;20;8;Primary Positive Substructure
Substructure_0056;resorcin-R;OC1=CC(O)=CC=C1;4;4;6;5;19;9;Primary Positive Substructure
Substructure_0068;"3,4-dimethoxy-H-phenyl-R, defined (9H; CH)";[R]C1=C([H])C([H])=C(OC([H])([H])[H])C(OC([H])([H])[H])=C1[H];2;1;10;6;19;9;Primary Positive Substructure
Substructure_0087;"2-hydroxy-H-phenyl-R, defined (1H; OH)";[R]C1=CC=CC=C1O[H];4;4;5;6;19;9;Primary Positive Substructure
Substructure_0012;aniline-R;NC1=CC=CC=C1;2;7;2;7;18;10;Primary Positive Substructure
Substructure_0035;"benzyl-R, defined (2H; CH)";[H]C([H])([R])C1=CC=CC=C1;3;5;4;6;18;10;Primary Positive Substructure
Substructure_0036;butylene;CCCC;5;8;2;3;18;10;Primary Positive Substructure
Substructure_0095;"4-hydroxy-H-phenyl-R, defined (1H; OH)";[R]C1=CC=C(O[H])C=C1;4;4;5;5;18;10;Primary Positive Substructure
Substructure_0022;diethylamine-R;CCNCC;4;7;2;3;16;11;Primary Positive Substructure
Substructure_0028;methylpropylamine-R;CNCCC;5;6;2;3;16;11;Primary Positive Substructure
Substructure_0100;"3-hydroxy-H-phenyl-R, defined (1H; OH)";[R]C1=CC=CC(O[H])=C1;4;3;5;4;16;11;Primary Positive Substructure
Substructure_0132;"4-hydroxy-H-phenyl-R, defined (5H; CH, OH)";[R]C1=C(C([H])=C(O[H])C([H])=C1[H])[H];1;2;5;8;16;11;Primary Positive Substructure
Substructure_0042;pentylene;CCCCC;4;6;2;3;15;12;Primary Positive Substructure
Substructure_0070;methylbutylamine-R;CNCCCC;4;6;2;3;15;12;Primary Positive Substructure
Substructure_0033;ethylpropylamine-R;CCNCCC;4;5;2;3;14;13;Primary Positive Substructure
Substructure_0041;"R-amid-N-H-R, defined (1H; NH)";[R]C(N([H])[R])=O;2;4;3;5;14;13;Primary Positive Substructure
Substructure_0055;"3,4-dihydroxy-R-phenyl-R, defined (3H; CH)";[R]C1=C(C([H])=C(C(O)=C1[H])O)[H];3;2;6;3;14;13;Primary Positive Substructure
Substructure_0201;"isopropyl, defined (7H; CH)";[R]C(C([H])([H])[H])([H])C([H])([H])[H];2;2;4;6;14;13;Primary Positive Substructure
Substructure_0218;2,4,6-trihydroxy-R-phenyl-R, defined (3H: CH);[R]C1=C(O)C([H])=C(C([H])=C1O)O;3;2;6;3;14;13;Primary Positive Substructure
Substructure_0093;"4-methoxy-H-phenyl-R, defined (7H; CH)";[R]C1=C([H])C([H])=C(C([H])=C1[H])OC([H])([H])[H];1;2;1;9;13;14;Primary Positive Substructure
Substructure_0144;flavone;O=C(C=C(C1=CC=CC=C1)O2)C3=C2C=CC=C3;4;1;7;1;13;14;Primary Positive Substructure
Substructure_0174;"resorcin-H, defined (2H; OH)";[H]OC1=CC(O[H])=CC=C1;3;2;5;3;13;14;Primary Positive Substructure
Substructure_0181;"2,4-dihydroxy-H-phenyl-R, defined (2H; OH)";[R]C1=CC=C(O[H])C=C1O[H];3;2;5;3;13;14;Primary Positive Substructure
Substructure_0193;"2-hydroxy-R-phenyl-R, defined (4H; CH)";[R]C1=C(C([H])=C(C([H])=C1O)[H])[H];1;2;4;6;13;14;Primary Positive Substructure
Substructure_0209;"3,5-dihydroxy-H-phenyl-R, defined (2H; OH)";[R]C1=CC(O[H])=CC(O[H])=C1;3;2;5;3;13;14;Primary Positive Substructure
Substructure_0026;benzoyl;[R]C(C1=CC=CC=C1)=O;1;4;1;6;12;15;Primary Positive Substructure
Substructure_0037;R-amid-N-R-R;[R]C(N[R])=O;2;4;2;4;12;15;Primary Positive Substructure
Substructure_0049;"phenethyl-R, defined (4H; CH)";[H]C([H])(C([H])([R])[H])C1=CC=CC=C1;2;3;3;4;12;15;Primary Positive Substructure
Substructure_0082;ethylbutylamine-R;CCNCCCC;4;4;2;2;12;15;Primary Positive Substructure
Substructure_0200;carboxylic acid-H, defined (1H: OH);[R]C(O[H])=O;2;2;4;4;12;15;Primary Positive Substructure
Substructure_0210;"4-chlorophenyl-R, defined (4H; CH)";[R]C1=C(C([H])=C(C([H])=C1[H])Cl)[H];1;2;1;8;12;15;Primary Positive Substructure
Substructure_0023;trimethylamino-R;CN(C)C;3;4;2;2;11;16;Primary Positive Substructure
Substructure_0080;methylpentylamine-R;CNCCCCC;4;3;2;2;11;16;Primary Positive Substructure
Substructure_0089;ethanol-R-amine-R;NCCO;2;5;1;3;11;16;Primary Positive Substructure
Substructure_0090;ethylpentylamine-R;CCNCCCCC;4;3;2;2;11;16;Primary Positive Substructure
Substructure_0059;isobutane;CC(C)C;2;5;1;2;10;17;Primary Positive Substructure
Substructure_0065;dipropylamin-R;CCCNCCC;3;3;2;2;10;17;Primary Positive Substructure
Substructure_0078;cyano;[R]C#N;2;2;3;3;10;17;Primary Positive Substructure
Substructure_0107;propylbutylamine-R;CCCNCCCC;3;3;2;2;10;17;Primary Positive Substructure
Substructure_0117;"3,4,5-trimethoxy-H-phenyl-R, defined (11H;CH)";[R]C1=C([H])C(OC([H])([H])[H])=C(OC([H])([H])[H])C(OC([H])([H])[H])=C1[H];1;1;1;7;10;17;Secondary Positive Substructure
Substructure_0122;propylpentylamine-R;CCCNCCCCC;3;3;2;2;10;17;Primary Positive Substructure
Substructure_0126;thioether;[R]S[R];3;3;2;2;10;17;Primary Positive Substructure
Substructure_0130;"amino-H, defined (2H; NH)";[R]N([H])[H];2;3;2;3;10;17;Primary Positive Substructure
Substructure_0208;"ethanol-H-amine-R, defined (1H; OH)";NCCO[H];2;4;1;3;10;17;Primary Positive Substructure
Substructure_0213;"acetyl, defined (3H; CH)";O=C([R])C([H])([H])[H];1;2;1;6;10;17;Primary Positive Substructure
Substructure_0230;"methanol-H, defined (3H; OH)";[H]OC([H])([H])[R];1;3;1;5;10;17;Primary Positive Substructure
Substructure_0063;hexylene;CCCCCC;2;4;1;2;9;18;Primary Positive Substructure
Substructure_0076;"piperazine-R, defined (8H; CH)";[H]C1([H])C([H])([H])NC([H])([H])C([H])([H])N1;1;2;2;4;9;18;Primary Positive Substructure
Substructure_0133;trifluoromethane-R;[R]C(F)(F)F;1;2;1;5;9;18;Primary Positive Substructure
Substructure_0147;"R-carboxylic acid methyl-H-ester, defined (3H; CH)";[R]C(OC([H])([H])[H])=O;1;2;1;5;9;18;Primary Positive Substructure
Substructure_0223;"ethylene glycol-R, defined (4H; CH)";[H]C(C([H])([H])O[R])([H])O[R];2;1;4;2;9;18;Primary Positive Substructure
Substructure_0240;"2-nitrophenyl-R, defined (4H; CH)";[R]C1=C(C([H])=C(C([H])=C1[N+]([O-])=O)[H])[H];1;1;1;6;9;18;Secondary Positive Substructure
Substructure_0261;3,5-dimethoxy-H-phenyl-R, defined (9H: CH);[R]C1=C([H])C(OC([H])([H])[H])=C([H])C(OC([H])([H])[H])=C1[H];1;1;1;6;9;18;Secondary Positive Substructure
Substructure_0278;"isobutyl, defined (9H; CH)";[R]C(C([H])([H])[H])(C([H])([H])[H])C([H])([H])[H];1;2;1;5;9;18;Primary Positive Substructure
Substructure_0531;"3,4-dihydroxy-H-phenyl-R, defined (5H; CH; OH)";[R]C1=C(C([H])=C(C(O[H])=C1[H])O[H])[H];1;1;2;5;9;18;Secondary Positive Substructure
Substructure_0719;ethylene-R-diamine-R;NCCN;2;4;1;2;9;18;Primary Positive Substructure
Substructure_0728;"3,4,5-trihydroxy-H-phenyl-R,defined (5H; CH, OH)";[R]C1=C(C(O[H])=C(C(O[H])=C1[H])O[H])[H];1;1;1;6;9;18;Secondary Positive Substructure
Substructure_0072;"ethylene-H-diamine-R, defined (4H; CH)";NC([H])([H])C([H])([H])N;1;3;1;3;8;19;Primary Positive Substructure
Substructure_0079;pyrrole-R;C1=CC=CN1;1;3;1;3;8;19;Primary Positive Substructure
Substructure_0083;isopentane;CC(CC)C;1;4;1;2;8;19;Primary Positive Substructure
Substructure_0099;methylhexylamine-R;CNCCCCCC;2;3;1;2;8;19;Primary Positive Substructure
Substructure_0111;"3-methoxy-H-phenyl-R, defined (7H; CH)";[R]C1=C([H])C([H])=C([H])C(OC([H])([H])[H])=C1[H];1;1;1;5;8;19;Secondary Positive Substructure
Substructure_0128;"ethanol-R-amine-N-H-R, defined (1H; NH)";OCCN[H];2;3;1;2;8;19;Primary Positive Substructure
Substructure_0145;thiophenol;[R]SC1=CC=CC=C1;1;3;1;3;8;19;Primary Positive Substructure
Substructure_0176;"2,4-dihydroxy-R-phenyl-R, defined (3H; CH)";[R]C1=C(C([H])=C(C([H])=C1O)O)[H];1;2;2;3;8;19;Primary Positive Substructure
Substructure_0195;"isopropanol-H, defined (3H; OH, CH)";[H]C([R])C(C([R])[H])O[H];1;3;1;3;8;19;Primary Positive Substructure
Substructure_0249;"2-methoxy-H-phenyl-R, defined (7H; CH)";[R]C1=C([H])C([H])=C([H])C([H])=C1OC([H])([H])[H];1;1;1;5;8;19;Secondary Positive Substructure
Substructure_0259;"ethanol-H, defined (5H; CH, OH)";[H]OC([H])([H])C([H])([H])[R];1;2;1;4;8;19;Primary Positive Substructure
Substructure_0280;"4-fluorophenyl-R, defined (4H; CH)";[R]C1=C(C([H])=C(C([H])=C1[H])F)[H];1;1;2;4;8;19;Secondary Positive Substructure
Substructure_0319;"dimethyl-H-amino-R, defined (6H; CH)";N(C([H])([H])[H])C([H])([H])[H];1;2;1;4;8;19;Primary Positive Substructure
Substructure_0614;"glycin-R, defined (3H; NH, OH)";O=C(O[H])CN([H])[H];2;1;3;2;8;19;Primary Positive Substructure
Substructure_0722;"thioethyl-H, defined (5H; CH)";[R]SC([H])(C([H])([H])[H])[H];1;2;1;4;8;19;Primary Positive Substructure
Substructure_0116;"3,4,5-trihydroxy-R-phenyl-R,defined (2H; CH)";[R]C1=C(C(O)=C(C(O)=C1[H])O)[H];1;1;1;4;7;20;Secondary Positive Substructure
Substructure_0120;indole-R;C12=C(C=CC=C2)NC=C1;1;2;1;3;7;20;Primary Positive Substructure
Substructure_0150;"3-pyridyl-R, defined (4H; CH)";[H]C1=C([R])C([H])=C([H])C([H])=N1;1;1;1;4;7;20;Secondary Positive Substructure
Substructure_0155;"toluyl, defined (3H; CH)";[H]C([H])([H])C1=CC=CC=C1;1;2;1;3;7;20;Primary Positive Substructure
Substructure_0157;dibutylamine-R;CCCCNCCCC;1;3;1;2;7;20;Primary Positive Substructure
Substructure_0159;4-chlorophenyl-R;[R]C1=CC=C(Cl)C=C1;1;2;1;3;7;20;Primary Positive Substructure
Substructure_0161;butylpentylamine-R;CCCCNCCCCC;1;3;1;2;7;20;Primary Positive Substructure
Substructure_0167;"isopropanol-H, defined (1H; OH)";[R]CC(C[R])O[H];1;3;1;2;7;20;Primary Positive Substructure
Substructure_0168;"isopropanol-H, defined (2H; CH, OH)";[R]CC(C([R])[H])O[H];1;3;1;2;7;20;Primary Positive Substructure
Substructure_0238;propylene-R-diamin-R;NCCCN;1;3;1;2;7;20;Primary Positive Substructure
Substructure_0241;thiomethyl-H, defined (3H: CH);[R]SC([H])([H])[H];1;2;1;3;7;20;Primary Positive Substructure
Substructure_0244;"4-bromophenyl-R, defined (4H; CH)";[R]C1=C(C([H])=C(C([H])=C1[H])Br)[H];1;1;1;4;7;20;Secondary Positive Substructure
Substructure_0290;butanol-R-amine-R;NCCCCO;1;3;1;2;7;20;Primary Positive Substructure
Substructure_0303;"isopropanol-R, defined (3H; CH)";[H]C([H])([R])C(C([H])([R])[H])O[H];1;2;1;3;7;20;Primary Positive Substructure
Substructure_0312;hydroquinone-R;OC1=CC=C(O)C=C1;1;2;1;3;7;20;Primary Positive Substructure
Substructure_0355;"4-amino-H-phenyl-R, defined (6H; CH; NH)";[R]C1=C(C([H])=C(N([H])[H])C([H])=C1[H])[H];1;1;1;4;7;20;Secondary Positive Substructure
Substructure_0360;"ethanol-H-amine-R, defined (5H; CH, OH)";NC([H])([H])C([H])([H])O[H];1;2;1;3;7;20;Primary Positive Substructure
Substructure_0416;"methyl-H-amino-H, defined (4H; CH; NH)";[R]N(C([H])([H])[H])[H];1;2;1;3;7;20;Primary Positive Substructure
Substructure_0480;"4-iodophenyl-R, defined (4H; CH)";[R]C1=C(C([H])=C(C([H])=C1[H])I)[H];1;1;1;4;7;20;Secondary Positive Substructure
Substructure_0481;"3-pyridylmethyl-R, defined (6H; CH)";[R]C([H])(C1=C([H])C([H])=C([H])N=C1[H])[H];1;1;1;4;7;20;Secondary Positive Substructure
Substructure_0532;"3,4-dihydroxy-H-phenyl-R, defined (2H; OH)";[R]C1=CC=C(O[H])C(O[H])=C1;1;2;1;3;7;20;Primary Positive Substructure
Substructure_0652;aldehyde;[R]C([H])=O;1;2;1;3;7;20;Primary Positive Substructure
Substructure_0723;"2,6-dihydroxy-R-phenyl-R, defined (3H; CH)";[R]C1=C(O)C([H])=C(C([H])=C1O)[H];1;2;1;3;7;20;Primary Positive Substructure
Substructure_0264;"diethyl-H-amino-R, defined (10H; CH)";[R]N(C(C([H])([H])[H])([H])[H])C(C([H])([H])[H])([H])[H];1;1;1;3;6;21;Secondary Positive Substructure
Substructure_0541;"thiomethyl-H-ethane-R, defined (7H; CH)";[R]C([H])([H])C([H])([H])SC([H])([H])[H];1;1;1;3;6;21;Secondary Positive Substructure
Substructure_0623;"tert-butyl-H-amino-H, defined (10H; CH, NH)";N(C(C([H])([H])[H])(C([H])([H])[H])C([H])([H])[H])[H];1;1;1;3;6;21;Secondary Positive Substructure
Substructure_0636;"ethanol-H-amine-N-H-R, defined (6H; CH, NH, OH)";[H]C([H])(C([H])(N[H])[H])O[H];1;1;1;3;6;21;Secondary Positive Substructure
Substructure_0732;"thioethyl-H-methane-R, defined (7H; CH)";[R]C([H])([H])SC(C([H])([H])[H])([H])[H];1;1;1;3;6;21;Secondary Positive Substructure
Substructure_0733;"thiobutyll-H, defined (9H; CH)";[R]SC(C([H])(C([H])(C([H])([H])[H])[H])[H])([H])[H];1;1;1;3;6;21;Secondary Positive Substructure
Substructure_0171;ethylene glycol-R;[R]OCCO[R];0;0;2;2;4;22;Secondary Positive Substructure
Substructure_0306;"ethanol-H-amine-N-H-R, defined (2H; NH, OH)";[H]NCCO[H];0;0;2;2;4;22;Secondary Positive Substructure
Substructure_0024;pyrimidine;C1=CC=NC=N1;0;0;1;2;3;23;Secondary Positive Substructure
Substructure_0061;nitro-R;[R][N+]([O-])=O;0;0;1;2;3;23;Secondary Positive Substructure
Substructure_0077;fluorine-R;[R]F;0;0;1;2;3;23;Secondary Positive Substructure
Substructure_0094;chlorine-R;[R]Cl;0;0;1;2;3;23;Secondary Positive Substructure
Substructure_0098;"3-hydroxy-R-phenyl-R, defined (4H; CH)";[R]C1=C(C([H])=C(C(O)=C1[H])[H])[H];0;0;1;2;3;23;Secondary Positive Substructure
Substructure_0177;3-trifluoromethylphenyl-R;[R]C1=CC=CC(C(F)(F)F)=C1;0;0;1;2;3;23;Secondary Positive Substructure
Substructure_0191;"isopropanol-H, defined (3H; OH, CH, CH)";[R]CC(C([H])([R])[H])O[H];0;0;1;2;3;23;Secondary Positive Substructure
Substructure_0198;"ethanol-R-amine-R, defined (4H; CH)";NC([H])([H])C([H])([H])O;0;0;1;2;3;23;Secondary Positive Substructure
Substructure_0222;"ethoxy-H, defined (5H; CH)";[R]OC([H])(C([H])([H])[H])[H];0;0;1;2;3;23;Secondary Positive Substructure
Substructure_0224;"isopropanol-R, defined (4H; OH, CH, CH2)";[H]C([R])C(C([H])([R])[H])O[H];0;0;1;2;3;23;Secondary Positive Substructure
Substructure_0245;diphenylmethyl;C1(CC2=CC=CC=C2)=CC=CC=C1;0;0;1;2;3;23;Secondary Positive Substructure
Substructure_0253;4-trifluoromethylphenyl-R;[R]C1=CC=C(C(F)(F)F)C=C1;0;0;1;2;3;23;Secondary Positive Substructure
Substructure_0258;"3,5-dihydroxy-R-phenyl-R, defined (3H; CH)";[R]C1=C(C(O)=C(C(O)=C1[H])[H])[H];0;0;1;2;3;23;Secondary Positive Substructure
Substructure_0269;"diphenylmethyl, defined (1H; CH)";[H]C(C1=CC=CC=C1)([R])C2=CC=CC=C2;0;0;1;2;3;23;Secondary Positive Substructure
Substructure_0291;"phenylpropyl, defined (6H; CH)";[H]C(C(C([H])([R])[H])([H])[H])([H])C1=CC=CC=C1;0;0;1;2;3;23;Secondary Positive Substructure
Substructure_0330;glycine-R;NCC(O)=O;0;0;2;1;3;23;Secondary Positive Substructure
Substructure_0356;"4-amino-H-phenyl-R, defined (2H; NH)";[R]C1=CC=C(N([H])[H])C=C1;0;0;1;2;3;23;Secondary Positive Substructure
Substructure_0361;"2,6-dihydroxy-H-phenyl-R, defined (2H; OH)";[R]C1=C(O[H])C=CC=C1O[H];0;0;1;2;3;23;Secondary Positive Substructure
Substructure_0367;7H-purine-R;C12=C(C=NC=N2)NC=N1;0;0;1;2;3;23;Secondary Positive Substructure
Substructure_0368;9H-purine-R;C1(NC=N2)=C2C=NC=N1;0;0;1;2;3;23;Secondary Positive Substructure
Substructure_0370;"2,5-dihydroxy-R-phenyl-R, defined 3H; CH)";[R]C1=C(C(O)=C(C([H])=C1O)[H])[H];0;0;1;2;3;23;Secondary Positive Substructure
Substructure_0386;iodine-R;[R]I;0;0;1;2;3;23;Secondary Positive Substructure
Substructure_0411;"3-amino-H-phenyl-R, defined (2H; NH)";[R]C1=CC=CC(N([H])[H])=C1;0;0;1;2;3;23;Secondary Positive Substructure
Substructure_0434;"vinyl, defined (3H; CH)";[R]/C([H])=C([H])/[H];0;0;1;2;3;23;Secondary Positive Substructure
Substructure_0524;"ethylene-H-diamine-H, defined (6H; CH, NH)";N([H])C([H])(C([H])(N([H]))[H])[H];0;0;1;2;3;23;Secondary Positive Substructure
Substructure_0533;"2,3-dihydroxy-R-phenyl-R, defined (3H; CH)";[R]C1=C(C([H])=C(C(O)=C1O)[H])[H];0;0;1;2;3;23;Secondary Positive Substructure
Substructure_0539;"thiomethyl-H-methane-R, defined (5H; CH)";[R]C([H])([H])SC([H])([H])[H];0;0;1;2;3;23;Secondary Positive Substructure
Substructure_0553;2-iodophenyl-R;[R]C1=CC=CC=C1I;0;0;1;2;3;23;Secondary Positive Substructure
Substructure_0555;3-iodophenyl-R;[R]C1=CC=CC(I)=C1;0;0;1;2;3;23;Secondary Positive Substructure
Substructure_0583;"glycine-R, defined (1H; NH)";[H]NCC(O)=O;0;0;2;1;3;23;Secondary Positive Substructure
Substructure_0584;"glycin-R, defined (1H; OH)";NCC(O[H])=O;0;0;2;1;3;23;Secondary Positive Substructure
Substructure_0607;"glycine-R, defined (2H; NH)";[H]N([H])CC(O)=O;0;0;2;1;3;23;Secondary Positive Substructure
Substructure_0608;"ethanol-R-amine-N-H-R, defined (5H; CH, NH)";OC([H])([H])C([H])([H])N[H];0;0;1;2;3;23;Secondary Positive Substructure
Substructure_0613;"glycin-R, defined (2H; NH, OH)";O=C(O[H])CN[H];0;0;2;1;3;23;Secondary Positive Substructure
Substructure_0615;glutamine-R;C(CC(=O)N)C(C(=O)O)N;0;0;2;1;3;23;Secondary Positive Substructure
Substructure_0642;hydroquinone-H, defined (2H, OH);[H]OC(C=C1)=CC=C1O[H];0;0;1;2;3;23;Secondary Positive Substructure
Substructure_0654;"2,5-dihydroxy-H-phenyl-R, defined (2H; OH)";[R]C1=CC(O[H])=CC=C1O[H];0;0;1;2;3;23;Secondary Positive Substructure
Substructure_0687;"methanethiol-H (3H; CH, SH)";[H]SC([H])([H])[R];0;0;1;2;3;23;Secondary Positive Substructure
Substructure_0700;2,6-diiodophenyl-R;[R]C1=C(I)C=CC=C1I;0;0;1;2;3;23;Secondary Positive Substructure
Substructure_0701;3,5-diiodophenyl-R;[R]C1=CC(I)=CC(I)=C1;0;0;1;2;3;23;Secondary Positive Substructure
Substructure_0724;"2,4,5-trihydroxy-R-phenyl-R, defined (2H; CH)";[R]C1=C(C(O)=C(C([H])=C1O)O)[H];0;0;1;2;3;23;Secondary Positive Substructure
Substructure_0726;azido;[N-]=[N+]=N[R];0;0;1;2;3;23;Secondary Positive Substructure
Substructure_0727;"2,3-dihydroxy-H-phenyl-R, defined (2H; OH)";[R]C1=CC=CC(O[H])=C1O[H];0;0;1;2;3;23;Secondary Positive Substructure
Substructure_0729;"3,4,5-trihydroxy-H-phenyl-R,defined (3H; OH)";[R]C1=CC(O[H])=C(O[H])C(O[H])=C1;0;0;1;2;3;23;Secondary Positive Substructure
Substructure_0074;piperazine-R;C1CNCCN1;0;0;1;1;2;24;Secondary Positive Substructure
Substructure_0108;prenyl;C/C(C)=C/C;0;0;1;1;2;24;Secondary Positive Substructure
Substructure_0110;ethylhexylamine-R;CCNCCCCCC;0;0;1;1;2;24;Secondary Positive Substructure
Substructure_0115;9-deazapurine;C1(C=CN2)=C2C=NC=N1;0;0;1;1;2;24;Secondary Positive Substructure
Substructure_0118;propanol-R-amine-R;NCCCO;0;0;1;1;2;24;Secondary Positive Substructure
Substructure_0119;piperidine-R;C1CCCCN1;0;0;1;1;2;24;Secondary Positive Substructure
Substructure_0121;naphthalene;C1(C=CC=C2)=C2C=CC=C1;0;0;1;1;2;24;Secondary Positive Substructure
Substructure_0125;methylheptylamine-R;CNCCCCCCC;0;0;1;1;2;24;Secondary Positive Substructure
Substructure_0146;3-chlorophenyl-R;[R]C1=CC=CC(Cl)=C1;0;0;1;1;2;24;Secondary Positive Substructure
Substructure_0149;propylhexylamine-R;CCCNCCCCCC;0;0;1;1;2;24;Secondary Positive Substructure
Substructure_0152;sulfoxid;[R]S([R])=O;0;0;1;1;2;24;Secondary Positive Substructure
Substructure_0153;sulfone;[R]S([R])(=O)=O;0;0;1;1;2;24;Secondary Positive Substructure
Substructure_0158;3-fluorophenyl-R;[R]C1=CC=CC(F)=C1;0;0;1;1;2;24;Secondary Positive Substructure
Substructure_0162;4-fluorophenyl-R;[R]C1=CC=C(F)C=C1;0;0;1;1;2;24;Secondary Positive Substructure
Substructure_0165;neopentane;CC(C)(C)C;0;0;1;1;2;24;Secondary Positive Substructure
Substructure_0166;2-nitrophenyl-R;[R]C1=CC=CC=C1[N+]([O-])=O;0;0;1;1;2;24;Secondary Positive Substructure
Substructure_0179;butylhexylamine-R;CCCCNCCCCCC;0;0;1;1;2;24;Secondary Positive Substructure
Substructure_0211;imidazole;C1=CN=CN1;0;0;1;1;2;24;Secondary Positive Substructure
Substructure_0231;propylene glycol-R;[R]OCCCO[R];0;0;1;1;2;24;Secondary Positive Substructure
Substructure_0232;butylene glycol-R;[R]OCCCCO[R];0;0;1;1;2;24;Secondary Positive Substructure
Substructure_0250;oxan;C1CCCCO1;0;0;1;1;2;24;Secondary Positive Substructure
Substructure_0298;"propanol-H-amine-R, defined (1H; OH)";NCCCO[H];0;0;1;1;2;24;Secondary Positive Substructure
Substructure_0307;"propanol-R-amine-N-H-R, defined (1H; NH)";OCCCN[H];0;0;1;1;2;24;Secondary Positive Substructure
Substructure_0320;butylene-R-diamine-R;NCCCCN;0;0;1;1;2;24;Secondary Positive Substructure
Substructure_0335;"butylene-R-diamine-H, defined (2H; NH)";N(CCCCN()[H])[H];0;0;1;1;2;24;Secondary Positive Substructure
Substructure_0337;"propanol-H-amine-N-H-R, defined (2H; NH; OH)";[H]NCCCO[H];0;0;1;1;2;24;Secondary Positive Substructure
Substructure_0346;isoflavone;O=C(C(C1=CC=CC=C1)=CO2)C3=C2C=CC=C3;0;0;1;1;2;24;Secondary Positive Substructure
Substructure_0347;alanine-R;CC(C(=O)O)N;0;0;1;1;2;24;Secondary Positive Substructure
Substructure_0357;"propylene-H-diamin-R, defined (6H; CH) ";NC([H])([H])C([H])([H])C([H])([H])N;0;0;1;1;2;24;Secondary Positive Substructure
Substructure_0358;"butanol-H-amine-R, defined (1H; OH)";NCCCCO[H];0;0;1;1;2;24;Secondary Positive Substructure
Substructure_0388; indoline-R;C12=C(NCC2)C=CC=C1;0;0;1;1;2;24;Secondary Positive Substructure
Substructure_0424;4-iodophenyl-R;[R]C1=CC=C(I)C=C1;0;0;1;1;2;24;Secondary Positive Substructure
Substructure_0609;"ethylene-R-diamine-H, defined (2H; NH)";[H]NCCN[H];0;0;1;1;2;24;Secondary Positive Substructure
Substructure_0629;"butylene-H-diamine-R, defined (8H; CH)";NC([H])([H])C([H])([H])C([H])([H])C([H])([H])N;0;0;1;1;2;24;Secondary Positive Substructure
Substructure_0686;"thiol-H (1H; SH)";[R]S[H];0;0;1;1;2;24;Secondary Positive Substructure
Substructure_0720;1,3-dithiane;C1CCSCS1;0;0;1;1;2;24;Secondary Positive Substructure
Substructure_0721;1,3-dithiane tetraoxid;O=S(CCCS1(=O)=O)(C1)=O;0;0;1;1;2;24;Secondary Positive Substructure
Substructure_0730;"3-thioethyl-H-phenyl-R, defined (5H; CH)";[R]C1=CC=CC(SC([H])(C([H])([H])[H])[H])=C1;0;0;1;1;2;24;Secondary Positive Substructure
Substructure_0731;"4-thioethyl-H-phenyl-R, defined (5H; CH)";[R]C1=CC=C(SC([H])(C([H])([H])[H])[H])C=C1;0;0;1;1;2;24;Secondary Positive Substructure
Substructure_0046;pyridine;C1=CC=CC=N1;0;0;0;1;1;25;Secondary Positive Substructure
Substructure_0088;heptylene;CCCCCCC;0;0;0;1;1;25;Secondary Positive Substructure
Substructure_0096;3-pyridyl-R;[R]C1=CC=C[N]=C1;0;0;0;1;1;25;Secondary Positive Substructure
Substructure_0102;octylene;CCCCCCCC;0;0;0;1;1;25;Secondary Positive Substructure
Substructure_0112;thiophene;C1=CC=CS1;0;0;0;1;1;25;Secondary Positive Substructure
Substructure_0123;cyclohexyl;C1CCCCC1;0;0;0;1;1;25;Secondary Positive Substructure
Substructure_0127;biphenyl;C1(C2=CC=CC=C2)=CC=CC=C1;0;0;0;1;1;25;Secondary Positive Substructure
Substructure_0140;nonylene;CCCCCCCCC;0;0;0;1;1;25;Secondary Positive Substructure
Substructure_0142;bromine-R;[R]Br;0;0;0;1;1;25;Secondary Positive Substructure
Substructure_0169;decylene;CCCCCCCCCC;0;0;0;1;1;25;Secondary Positive Substructure
Substructure_0184;ethylheptylamine-R;CCNCCCCCCC;0;0;0;1;1;25;Secondary Positive Substructure
Substructure_0216;4-bromophenyl-R;[R]C1=CC=C(Br)C=C1;0;0;0;1;1;25;Secondary Positive Substructure
Substructure_0217;chromane;C1(CCCO2)=C2C=CC=C1;0;0;0;1;1;25;Secondary Positive Substructure
Substructure_0221;p-phenylene-R-diamine-R;NC1=CC=C(N)C=C1;0;0;0;1;1;25;Secondary Positive Substructure
Substructure_0225; methyloctylamine-R;CNCCCCCCCC;0;0;0;1;1;25;Secondary Positive Substructure
Substructure_0226;ethyloctylamine-R;CCNCCCCCCCC;0;0;0;1;1;25;Secondary Positive Substructure
Substructure_0236;methylnonylamine-R;CNCCCCCCCCC;0;0;0;1;1;25;Secondary Positive Substructure
Substructure_0237;ethylnonylamine-R;CCNCCCCCCCCC;0;0;0;1;1;25;Secondary Positive Substructure
Substructure_0255;propylheptylamine-R;CCCNCCCCCCC;0;0;0;1;1;25;Secondary Positive Substructure
Substructure_0266;pyrrolidin-R;C1CCCN1;0;0;0;1;1;25;Secondary Positive Substructure
Substructure_0272;dihydropyridine-R;C1=CNC=CC1;0;0;0;1;1;25;Secondary Positive Substructure
Substructure_0273;benzo-1,3-dioxolan;C1(C=CC=C2)=C2OCO1;0;0;0;1;1;25;Secondary Positive Substructure
Substructure_0297;methanol-R-amine-R;NCO;0;0;0;1;1;25;Secondary Positive Substructure
Substructure_0299;oxolan;C1CCCO1;0;0;0;1;1;25;Secondary Positive Substructure
Substructure_0318;"2-amino-H-phenyl-R, defined (2H; NH)";[R]C1=CC=CC=C1N([H])[H];0;0;0;1;1;25;Secondary Positive Substructure
Substructure_0323;"4-thiomethyl-H-phenyl-R, defined (3H; CH)";[R]C1=CC=C(SC([H])([H])[H])C=C1;0;0;0;1;1;25;Secondary Positive Substructure
Substructure_0327;o-phenylene-R-diamine-R;NC1=CC=CC=C1N;0;0;0;1;1;25;Secondary Positive Substructure
Substructure_0340;"3-thiomethyl-H-phenyl-R, defined (3H; CH)";[R]C1=CC=CC(SC([H])([H])[H])=C1;0;0;0;1;1;25;Secondary Positive Substructure
Substructure_0349;propyloctylamine-R;CCCNCCCCCCCC;0;0;0;1;1;25;Secondary Positive Substructure
Substructure_0359;"butanol-R-amine-N-H-R, defined (1H; NH)";OCCCCN[H];0;0;0;1;1;25;Secondary Positive Substructure
Substructure_0375;methyldecylamine-R;CNCCCCCCCCCC;0;0;0;1;1;25;Secondary Positive Substructure
Substructure_0390;"3-pyridylmethyl-R, defined (2H; CH)";[R]C([H])([H])C1=CC=CN=C1;0;0;0;1;1;25;Secondary Positive Substructure
Substructure_0400;butylheptylamine-R;CCCCNCCCCCCC;0;0;0;1;1;25;Secondary Positive Substructure
Substructure_0417;"butanol-H-amine-N-H-R, defined (2H; NH; OH)";[H]NCCCCO[H];0;0;0;1;1;25;Secondary Positive Substructure
Substructure_0426;tetrahydronaphthalene;C12=C(C=CC=C2)CCCC1;0;0;0;1;1;25;Secondary Positive Substructure
Substructure_0530;azecane-R;C1CCCCCCCNC1;0;0;0;1;1;25;Secondary Positive Substructure
Substructure_0561;indan;C1(C=CC=C2)=C2CCC1;0;0;0;1;1;25;Secondary Positive Substructure
Substructure_0568;decahydroisoquinoline-R;C12CNCCC1CCCC2;0;0;0;1;1;25;Secondary Positive Substructure
Substructure_0618;dihydrofuan-2-one;O=C1OCCC1;0;0;0;1;1;25;Secondary Positive Substructure
Substructure_0625;aznonane-R;C1CCCCCCNC1;0;0;0;1;1;25;Secondary Positive Substructure
Substructure_0637;1,3-dioxane;C1CCOCO1;0;0;0;1;1;25;Secondary Positive Substructure
Substructure_0640;octahydroindole-R;C12C(CCCC2)NCC1;0;0;0;1;1;25;Secondary Positive Substructure
Substructure_0716;1,2,3,5,8,8a-hexahydroindolizine;N12CC=CCC1CCC2;0;0;0;1;1;25;Secondary Positive Substructure
Substructure_0725;2,4,6-cyclohepten-1-on;O=C1C=CC=CC=C1;0;0;0;1;1;25;Secondary Positive Substructure
Substructure_0734;carbazole;C1(C(C=CC=C2)=C2N3)=C3C=CC=C1;0;0;0;1;1;25;Secondary Positive Substructure
